20;20;0;0;
0_0_0_0_0_0_0_0_0_0_0_0_0_0_0_0_0_0_0_0-
0_0_0_0_0_0_0_0_0_0_0_0_0_0_0_0_0_0_0_0-
0_0_1_1_1_0_0_0_0_0_0_0_0_0_0_0_0_0_0_0-
0_0_0_1_1_0_0_0_0_0_0_0_0_0_0_0_0_0_0_0-
0_0_0_1_1_1_0_0_0_0_0_0_0_0_0_0_0_0_0_0-
0_0_0_0_0_0_0_0_0_0_0_0_0_0_0_0_0_0_0_0-
0_0_0_0_0_0_0_0_0_0_0_0_0_0_0_0_0_0_0_0-
0_0_0_0_0_0_0_0_0_0_0_0_0_0_1_0_0_0_0_0-
0_0_0_0_0_0_0_0_0_0_0_0_0_0_0_1_1_0_0_0-
0_0_0_1_0_0_0_0_0_0_0_0_0_0_0_0_1_0_0_0-
0_0_0_1_0_0_0_0_0_0_0_0_0_0_0_1_0_0_0_0-
0_0_1_1_0_0_0_0_0_0_0_0_0_0_0_0_1_0_0_0-
0_0_1_1_0_0_0_0_0_0_0_0_0_0_0_0_0_0_0_0-
0_0_0_1_0_0_0_0_0_0_0_0_0_0_0_0_0_0_0_0-
0_0_0_0_0_0_0_0_0_0_0_0_0_0_0_0_0_0_0_0-
0_0_0_0_0_0_0_0_0_0_0_0_0_0_0_0_0_0_0_0-
0_0_0_0_0_0_0_0_0_0_0_0_0_0_0_0_0_0_0_0-
0_0_0_0_0_0_0_0_0_0_0_0_0_0_0_0_0_0_0_0-
0_0_0_0_0_0_0_0_0_0_0_0_0_0_0_0_0_0_0_0-
0_0_0_0_0_0_0_0_0_0_0_0_0_0_0_0_0_0_0_0